30 seconds=30 sekund
1 minute=1 minuta
2 minutes=2 minuty
5 minutes=5 minut
10 minutes=10 minut
30 minutes=30 minut
1 hour=1 godzina
2 hours=2 godziny
Above=Powyżej
Array must be Started to view disk stats=Aby statystyki dysku były widoczne macież musi być **Uruchomiona**
Array must be Started to view system stats=Aby statystyki systemu były widoczne macież musi być **Uruchomiona**
Available for Data=Dostępne dla Danych
Below=Poniżej
CPU Load=Obciążenie CPU
Disk Usage=Użycie Dysku
disks=dyski
High on Usage=Wysokie Użycie
Last day=Ostatni dzień
Last 2 days=Ostatnie 2 dni
Last 3 days=Ostatnie 3 dni
Last week=Ostatni tydzień
Last 2 weeks=Ostatnie 2 tygodnie
Last 3 weeks=Ostatnie 3 tygodnie
Last month=Ostatni miesiąc
Low on Space=Mało miejsca
Normal Usage=Normalne Użycie
Real-time=Czas rzeczywisty
Since start=Od uruchomienia
Storage=Magazyn
Total Array Size=Całkowity rozmiar Macierzy
Total Space Used=Wykorzystane miejsce
Used for Parity=Wykorzystane dla danych Parzystości
utilization in percentage=wykorzystanie w procentach
